X   Y   Z
5   0   4
4   0   3
2   0   3
3   0   2
5   0   1
0   1   3
0   3   3
0   1   2
0   2   1
0   5   1
5   1   0
5   2   0
4   3   0
3   4   0
2   5   0